# Список пустых категорий (107 шт.)
# Дата создания: 14.07.2025, 02:16:12
# Всего категорий в анализе: 691
# Без ссылок

hotline-akkumulyatory (файл: hotline-akkumulyatory.json)
hotline-aksessuary-dlya-shvejnyh-mashin (файл: hotline-aksessuary-dlya-shvejnyh-mashin.json)
hotline-aksessuary-dlya-zaryadki (файл: hotline-aksessuary-dlya-zaryadki.json)
totalCategories (файл: hotline-all-categories-report0.json)
totalProducts (файл: hotline-all-categories-report0.json)
categories (файл: hotline-all-categories-report0.json)
timestamp (файл: hotline-all-categories-report0.json)
totalCategories (файл: hotline-all-categories-report1.json)
totalProducts (файл: hotline-all-categories-report1.json)
categories (файл: hotline-all-categories-report1.json)
timestamp (файл: hotline-all-categories-report1.json)
hotline-analnye-stimulyatory (файл: hotline-analnye-stimulyatory.json)
hotline-audio (файл: hotline-audio.json)
hotline-avto-svet (файл: hotline-avto-svet.json)
hotline-avtoelektronika (файл: hotline-avtoelektronika.json)
hotline-avtohimiya (файл: hotline-avtohimiya.json)
hotline-avtomobilnoe-audio-i-video (файл: hotline-avtomobilnoe-audio-i-video.json)
hotline-avtooborudovanie (файл: hotline-avtooborudovanie.json)
hotline-avtotelevizory (файл: hotline-avtotelevizory.json)
hotline-bytovaya-himiyapoint-hoztovary (файл: hotline-bytovaya-himiyapoint-hoztovary.json)
hotline-bytovye-medicinskie-pribory (файл: hotline-bytovye-medicinskie-pribory.json)
hotline-chokhly-ta-zakhysni-plivky (файл: hotline-chokhly-ta-zakhysni-plivky.json)
hotline-dachnoe-elektropitanie (файл: hotline-dachnoe-elektropitanie.json)
hotline-detskaya-mebel (файл: hotline-detskaya-mebel.json)
hotline-detskie-igrushki (файл: hotline-detskie-igrushki.json)
hotline-detskij-transport (файл: hotline-detskij-transport.json)
hotline-dlya-malyshej (файл: hotline-dlya-malyshej.json)
hotline-dlya-sporta (файл: hotline-dlya-sporta.json)
hotline-domashnie-kinoteatry (файл: hotline-domashnie-kinoteatry.json)
hotline-domashnij-tekstil (файл: hotline-domashnij-tekstil.json)
hotline-dopolnitelnoe-oborudovanie-i-aksessuary (файл: hotline-dopolnitelnoe-oborudovanie-i-aksessuary.json)
hotline-elektropitanie (файл: hotline-elektropitanie.json)
hotline-eroticheskaya-odezhda (файл: hotline-eroticheskaya-odezhda.json)
hotline-fotoapparaty-obektivy (файл: hotline-fotoapparaty-obektivy.json)
hotline-gazovye-ulichnye-obogrevateli (файл: hotline-gazovye-ulichnye-obogrevateli.json)
hotline-interer (файл: hotline-interer.json)
hotline-internet-i-televidenie (файл: hotline-internet-i-televidenie.json)
hotline-intim (файл: hotline-intim.json)
hotline-kalibratory (файл: hotline-kalibratory.json)
hotline-kislorodnye-koncentratory (файл: hotline-kislorodnye-koncentratory.json)
hotline-klimaticheskaya-tehnika (файл: hotline-klimaticheskaya-tehnika.json)
hotline-koliasky (файл: hotline-koliasky.json)
hotline-kolyaski-i-avtokresla (файл: hotline-kolyaski-i-avtokresla.json)
hotline-komplektuyuschie-dlya-pk (файл: hotline-komplektuyuschie-dlya-pk.json)
hotline-komplekty-signalizacij (файл: hotline-komplekty-signalizacij.json)
hotline-kompostery (файл: hotline-kompostery.json)
hotline-kompyuternaya-periferiya (файл: hotline-kompyuternaya-periferiya.json)
hotline-konstruktory-lego (файл: hotline-konstruktory-lego.json)
hotline-kontaktnye-linzypoint-ochki (файл: hotline-kontaktnye-linzypoint-ochki.json)
hotline-krupnaya-bytovaya-tehnika (файл: hotline-krupnaya-bytovaya-tehnika.json)
hotline-lampy-dlya-vyraschivaniya-rastenij (файл: hotline-lampy-dlya-vyraschivaniya-rastenij.json)
hotline-lejki (файл: hotline-lejki.json)
hotline-matrichnye-printery (файл: hotline-matrichnye-printery.json)
hotline-mebel (файл: hotline-mebel.json)
hotline-melkaya-tehnika-dlya-kuhni (файл: hotline-melkaya-tehnika-dlya-kuhni.json)
hotline-moto (файл: hotline-moto.json)
hotline-nastolnye-pk-monitory (файл: hotline-nastolnye-pk-monitory.json)
hotline-noutbuki-pk (файл: hotline-noutbuki-pk.json)
hotline-novogodnie-tovary (файл: hotline-novogodnie-tovary.json)
hotline-ochistiteli-kolesnyh-diskov (файл: hotline-ochistiteli-kolesnyh-diskov.json)
hotline-opticheskie-nakopiteli (файл: hotline-opticheskie-nakopiteli.json)
hotline-osveschenie-electrica (файл: hotline-osveschenie-electrica.json)
hotline-otopleniepoint-vodonagrevateli (файл: hotline-otopleniepoint-vodonagrevateli.json)
hotline-parfyumeriya (файл: hotline-parfyumeriya.json)
hotline-parovarki (файл: hotline-parovarki.json)
hotline-personalnyi-dogliad (файл: hotline-personalnyi-dogliad.json)
hotline-pivovarnipoint-distillyatory (файл: hotline-pivovarnipoint-distillyatory.json)
hotline-populyarno-seychas-bt (файл: hotline-populyarno-seychas-bt.json)
hotline-populyarno-seychas-dacha-sad (файл: hotline-populyarno-seychas-dacha-sad.json)
hotline-posuda (файл: hotline-posuda.json)
hotline-powerline-adaptery (файл: hotline-powerline-adaptery.json)
hotline-print-servery (файл: hotline-print-servery.json)
hotline-printery-mfu-plottery (файл: hotline-printery-mfu-plottery.json)
hotline-products (файл: hotline-products.json)
hotline-produkty-napitki-alkogol (файл: hotline-produkty-napitki-alkogol.json)
hotline-projectors (файл: hotline-projectors.json)
hotline-rastvorypoint-kaplipoint-aksessuary-dlya-linz (файл: hotline-rastvorypoint-kaplipoint-aksessuary-dlya-linz.json)
hotline-ruchnoj-sadovyj-instrument (файл: hotline-ruchnoj-sadovyj-instrument.json)
hotline-sadovaya-mebelpoint-interer (файл: hotline-sadovaya-mebelpoint-interer.json)
hotline-sadovaya-tehnika (файл: hotline-sadovaya-tehnika.json)
hotline-sadovodstvo-fermerstvo (файл: hotline-sadovodstvo-fermerstvo.json)
hotline-setevoe-oborudovanie (файл: hotline-setevoe-oborudovanie.json)
hotline-shiny-i-diski (файл: hotline-shiny-i-diski.json)
hotline-sistemy-kontrolya-davleniya-v-shinah (файл: hotline-sistemy-kontrolya-davleniya-v-shinah.json)
hotline-smart-technika (файл: hotline-smart-technika.json)
hotline-sredstva-multimedia (файл: hotline-sredstva-multimedia.json)
hotline-sumki-i-aksessuary (файл: hotline-sumki-i-aksessuary.json)
hotline-tehnika-dlya-doma (файл: hotline-tehnika-dlya-doma.json)
hotline-tehpomosch (файл: hotline-tehpomosch.json)
hotline-televizionnye-antenny (файл: hotline-televizionnye-antenny.json)
hotline-televizory-proektory (файл: hotline-televizory-proektory.json)
hotline-tovary-dlya-krasoty-i-personalnogo-uhoda (файл: hotline-tovary-dlya-krasoty-i-personalnogo-uhoda.json)
hotline-tovary-dlya-shkoly (файл: hotline-tovary-dlya-shkoly.json)
hotline-tovary-medicinskogo-naznacheniya (файл: hotline-tovary-medicinskogo-naznacheniya.json)
hotline-tv-tyunery (файл: hotline-tv-tyunery.json)
hotline-uhod-i-reabilitaciya (файл: hotline-uhod-i-reabilitaciya.json)
hotline-uhod-za-telom (файл: hotline-uhod-za-telom.json)
hotline-umnyj--dom (файл: hotline-umnyj--dom.json)
hotline-vetro-solnechnye-kontrollery (файл: hotline-vetro-solnechnye-kontrollery.json)
hotline-vetrogeneratory (файл: hotline-vetrogeneratory.json)
hotline-videokamery-i-videooborudovanie (файл: hotline-videokamery-i-videooborudovanie.json)
hotline-vodosnabzheniepoint-polivpoint-kanalizaciya (файл: hotline-vodosnabzheniepoint-polivpoint-kanalizaciya.json)
hotline-vstraivaemaya-tehnika (файл: hotline-vstraivaemaya-tehnika.json)
hotline-vstroennye-pylesosy (файл: hotline-vstroennye-pylesosy.json)
hotline-vyazalnye-mashiny (файл: hotline-vyazalnye-mashiny.json)
hotline-zaryadka-i-sinhronizaciya (файл: hotline-zaryadka-i-sinhronizaciya.json)
hotline-zernodrobilki (файл: hotline-zernodrobilki.json)